11111111111111111111111111111111111111111111111111111111111111111111111111111111111111111111111111111111111111111111111111111111111111111111111111111111
10010000001000000000000000010000100000000000000000000000000000000000000000000000000000000000000000000000000000000000000100001000000000000000010000001001
10011111111000000000000000010000100000000000000000000000000000000000000000000000000000000000000000000000000000000000000100001000000000000000011111111001
10010000001000000000000000010000100000000000000000000000000000000000000000000000000000000000000000000000000000000000000100001000000000000000010000001001
11111111111111111111111111111111100000000000000000000000000000000000000000000000000000000000000000000000000000000000000111111111111111111111111111111111
10010000001000000000000000010000100000000000000000000000000000000000000000000000000000000000000000000000000000000000000100001000000000000000010000001001
11111111111111111111111111111111100000000000000000000000000000000000000000000000000000000000000000000000000000000000000111111111111111111111111111111111
10010000001000000000000000010000100000000000000000000000000000000000000000111111111111111111111111111111111111111111111100001000000000000000010000001001
11111111111111111111111111111111220000000002222222000000000000000000000000100000000000000000000000000000000000000000000111111111111111111111111111111111
10010000001000000000000000010000221111111002000002001000000000000000000000100000000000000000000000000000000000000000000100001000000000000000010000001001
11111111111111111111111111111111220000111002000002001111111111111111111111100000000000000000000000000000000000000000000111111111111111111111111111111111
10010000001000000000000000010000100000111002000002001111000000000000000000000000000000011111111111111111111111111111111100001000000000000000010000001001
11111111111111111111111111111111100000111002000002001111000000000000000000000000000000010000000000000000000000000000000111111111111111111111111111111111
10010000001000000000000000010000100000111002000002001111111111111111111111111111111111110000000000000000000000000000000100001000000000000000010000001001
11111111111111111111111111111111100000000002222222000000000000000000000000000000000000000000000000000000000000000000000111111111111111111111111111111111
10010000001000000000000000010000100000000000000000000000000000000000000000000000000000000000000000000000000000000000000100001000000000000000010000001001
11111111111111111111111111111111100000000000000000000000000000000000000000000000000000000000000000000000000000000000000111111111111111111111111111111111
10010000001000000000000000010000100000000000000000000000000000000000000000111111111111111111111111111111111111111111111100001000000000000000010000001001
11111111111111111111111111111111220000000002222222000000000000000000000000100000000000000000000000000000000000000000000111111111111111111111111111111111
10010000001000000000000000010000221111111002000002001000000000000000000000100000000000000000000000000000000000000000000100001000000000000000010000001001
11111111111111111111111111111111220000111002000002001111111111111111111111100000000000000000000000000000000000000000000111111111111111111111111111111111
10010000001000000000000000010000100000111002000002001111000000000000000000000000000000011111111111111111111111111111111100001000000000000000010000001001
11111111111111111111111111111111100000111002000002001111000000000000000000000000000000010000000000000000000000000000000111111111111111111111111111111111
10010000001000000000000000010000100000111002000002001111111111111111111111111111111111110000000000000000000000000000000100001000000000000000010000001001
11111111111111111111111111111111100000000002222222000000000000000000000000000000000000000000000000000000000000000000000111111111111111111111111111111111
10010000001000000000000000010000100000000000000000000000000000000000000000000000000000000000000000000000000000000000000100001000000000000000010000001001
11111111111111111111111111111111100000000000000000000000000000000000000000000000000000000000000000000000000000000000000111111111111111111111111111111111
10010000001000000000000000010000100000000000000000000000000000000000000000111111111111111111111111111111111111111111111100001000000000000000010000001001
11111111111111111111111111111111220000000002222222000000000000000000000000100000000000000000000000000000000000000000000111111111111111111111111111111111
10010000001000000000000000010000221111111002000002001000000000000000000000100000000000000000000000000000000000000000000100001000000000000000010000001001
11111111111111111111111111111111220000111002000002001111111111111111111111100000000000000000000000000000000000000000000111111111111111111111111111111111
10010000001000000000000000010000100000111002000002001111000000000000000000000000000000011111111111111111111111111111111100001000000000000000010000001001
11111111111111111111111111111111100000111002000002001111000000000000000000000000000000010000000000000000000000000000000111111111111111111111111111111111
10010000001000000000000000010000100000111002000002001111111111111111111111111111111111110000000000000000000000000000000100001000000000000000010000001001
11111111111111111111111111111111100000000002222222000000000000000000000000000000000000000000000000000000000000000000000111111111111111111111111111111111
10010000001000000000000000010000100000000000000000000000000000000000000000000000000000000000000000000000000000000000000100001000000000000000010000001001
11111111111111111111111111111111100000000000000000000000000000000000000000000000000000000000000000000000000000000000000111111111111111111111111111111111
10010000001000000000000000010000100000000000000000000000000000000000000000111111111111111111111111111111111111111111111100001000000000000000010000001001
11111111111111111111111111111111220000000002222222000000000000000000000000100000000000000000000000000000000000000000000111111111111111111111111111111111
10010000001000000000000000010000221111111002000002001000000000000000000000100000000000000000000000000000000000000000000100001000000000000000010000001001
11111111111111111111111111111111220000111002000002001111111111111111111111100000000000000000000000000000000000000000000111111111111111111111111111111111
10010000001000000000000000010000100000111002000002001111000000000000000000000000000000011111111111111111111111111111111100001000000000000000010000001001
11111111111111111111111111111111100000111002000002001111000000000000000000000000000000010000000000000000000000000000000111111111111111111111111111111111
10010000001000000000000000010000100000111002000002001111111111111111111111111111111111110000000000000000000000000000000100001000000000000000010000001001
11111111111111111111111111111111100000000002222222000000000000000000000000000000000000000000000000000000000000000000000111111111111111111111111111111111
10010000001000000000000000010000100000000000000000000000000000000000000000000000000000000000000000000000000000000000000100001000000000000000010000001001
11111111111111111111111111111111100000000000000000000000000000000000000000000000000000000000000000000000000000000000000111111111111111111111111111111111
10010000001000000000000000010000100000000000000000000000000000000000000000111111111111111111111111111111111111111111111100001000000000000000010000001001
11111111111111111111111111111111220000000002222222000000000000000000000000100000000000000000000000000000000000000000000111111111111111111111111111111111
10010000001000000000000000010000221111111002000002001000000000000000000000100000000000000000000000000000000000000000000100001000000000000000010000001001
11111111111111111111111111111111220000111002000002001111111111111111111111100000000000000000000000000000000000000000000111111111111111111111111111111111
10010000001000000000000000010000100000111002000002001111000000000000000000000000000000011111111111111111111111111111111100001000000000000000010000001001
11111111111111111111111111111111100000111002000002001111000000000000000000000000000000010000000000000000000000000000000111111111111111111111111111111111
10010000001000000000000000010000100000111002000002001111111111111111111111111111111111110000000000000000000000000000000100001000000000000000010000001001
11111111111111111111111111111111100000000002222222000000000000000000000000000000000000000000000000000000000000000000000111111111111111111111111111111111
10010000001000000000000000010000100000000000000000000000000000000000000000000000000000000000000000000000000000000000000100001000000000000000010000001001
11111111111111111111111111111111100000000000000000000000000000000000000000000000000000000000000000000000000000000000000111111111111111111111111111111111
10010000001000000000000000010000100000000000000000000000000000000000000000111111111111111111111111111111111111111111111100001000000000000000010000001001
11111111111111111111111111111111220000000002222222000000000000000000000000100000000000000000000000000000000000000000000111111111111111111111111111111111
10010000001000000000000000010000221111111002000002001000000000000000000000100000000000000000000000000000000000000000000100001000000000000000010000001001
11111111111111111111111111111111220000111002000002001111111111111111111111100000000000000000000000000000000000000000000111111111111111111111111111111111
10010000001000000000000000010000100000111002000002001111000000000000000000000000000000011111111111111111111111111111111100001000000000000000010000001001
11111111111111111111111111111111100000111002000002001111000000000000000000000000000000010000000000000000000000000000000111111111111111111111111111111111
10010000001000000000000000010000100000111002000002001111111111111111111111111111111111110000000000000000000000000000000100001000000000000000010000001001
11111111111111111111111111111111100000000002222222000000000000000000000000000000000000000000000000000000000000000000000111111111111111111111111111111111
10010000001000000000000000010000100000000000000000000000000000000000000000000000000000000000000000000000000000000000000100001000000000000000010000001001
11111111111111111111111111111111100000000000000000000000000000000000000000000000000000000000000000000000000000000000000111111111111111111111111111111111
10010000001000000000000000010000100000000000000000000000000000000000000000111111111111111111111111111111111111111111111100001000000000000000010000001001
11111111111111111111111111111111220000000002222222000000000000000000000000100000000000000000000000000000000000000000000111111111111111111111111111111111
10010000001000000000000000010000221111111002000002001000000000000000000000100000000000000000000000000000000000000000000100001000000000000000010000001001
11111111111111111111111111111111220000111002000002001111111111111111111111100000000000000000000000000000000000000000000111111111111111111111111111111111
10010000001000000000000000010000100000111002000002001111000000000000000000000000000000011111111111111111111111111111111100001000000000000000010000001001
11111111111111111111111111111111100000111002000002001111000000000000000000000000000000010000000000000000000000000000000111111111111111111111111111111111
10010000001000000000000000010000100000111002000002001111111111111111111111111111111111110000000000000000000000000000000100001000000000000000010000001001
11111111111111111111111111111111100000000002222222000000000000000000000000000000000000000000000000000000000000000000000111111111111111111111111111111111
10010000001000000000000000010000100000000000000000000000000000000000000000000000000000000000000000000000000000000000000100001000000000000000010000001001
11111111111111111111111111111111100000000000000000000000000000000000000000000000000000000000000000000000000000000000000111111111111111111111111111111111
10010000001000000000000000010000100000000000000000000000000000000000000000111111111111111111111111111111111111111111111100001000000000000000010000001001
11111111111111111111111111111111220000000002222222000000000000000000000000100000000000000000000000000000000000000000000111111111111111111111111111111111
10010000001000000000000000010000221111111002000002001000000000000000000000100000000000000000000000000000000000000000000100001000000000000000010000001001
11111111111111111111111111111111220000111002000002001111111111111111111111100000000000000000000000000000000000000000000111111111111111111111111111111111
10010000001000000000000000010000100000111002000002001111000000000000000000000000000000011111111111111111111111111111111100001000000000000000010000001001
11111111111111111111111111111111100000111002000002001111000000000000000000000000000000010000000000000000000000000000000111111111111111111111111111111111
10010000001000000000000000010000100000111002000002001111111111111111111111111111111111110000000000000000000000000000000100001000000000000000010000001001
11111111111111111111111111111111100000000002222222000000000000000000000000000000000000000000000000000000000000000000000111111111111111111111111111111111
10010000001000000000000000010000100000000000000000000000000000000000000000000000000000000000000000000000000000000000000100001000000000000000010000001001
11111111111111111111111111111111100000000000000000000000000000000000000000000000000000000000000000000000000000000000000111111111111111111111111111111111
10010000001000000000000000010000100000000000000000000000000000000000000000000000000000000000000000000000000000000000000100001000000000000000010000001001
11111111111111111111111111111111100000000000000000000000000000000000000000000000000000000000000000000000000000000000000111111111111111111111111111111111
10010000001000000000000000010000100000000000000000000000000000000000000000000000000000000000000000000000000000000000000100001000000000000000010000001001
11111111111111111111111111111111100000000000000000000000000000000000000000000000000000000000000000000000000000000000000111111111111111111111111111111111
10010000001000000000000000010000100000000000000000000000000000000000000000000000000000000000000000000000000000000000000100001000000000000000010000001001
11111111111111111111111111111111100000000000000000000000000000000000000000000000000000000000000000000000000000000000000111111111111111111111111111111111
10010000001000000000000000010000100000000000000000000000000000000000000000000000000000000000000000000000000000000000000100001000000000000000010000001001
11111111111111111111111111111111100000000000000000000000000000000000000000000000000000000000000000000000000000000000000111111111111111111111111111111111
10010000001000000000000000010000100000000000000000000000000000000000000000000000000000000000000000000000000000000000000100001000000000000000010000001001
11111122222222222222111111111111111111111111111111111111111111111111111111111111111111111111111111111111111111111111111111111111111111111111111111111111
10000020000000000002000100000000000000001000000000100000000000000001000000100000001000010000000000000000100000010000000100000000000000000000010000000001
10000020000000000002000100000000000000001111111111101111111111111111011111101111111011110111111111111111101111110111111100000000000000000000010000000001
10000020000000000002000100000000000000001000000000100000000000000001000000100000001000010000000000000000100000010000000100000000000000000000011111111111
10000020000000000002000100000000000000001111111111101111111111111111011111101111111011110111111111111111101111110111111100000000000000000000010000000001
10000020000000000002000100000000000000001000000000100000000000000001000000100000001000010000000000000000100000010000000100000000000000000000010000000001
10000022222222222222000100000000000000001111111111101111111111111111011111101111111011110111111111111111101111110111111111111111111111111111111111111111
10000000000000000000000100000000000000001000000000100000000000000001000000100000001000010000000000000000100000010000000100000000000000000000000000000001
10000000000000000000000111111111111111111111111111111111111111111111111111111111111111111111111111111111111111111111111100000000000000000000000000000001
10000000000000000000000100000010000000000000000000000000000000000000000000000000000000000000000000000000000000000000000111111111111111111111111111111111
10000000000000000000000100000010000000000000000000000000000000000000000000000000000000000000000000000000000000000000000100000000000000000000000000000001
10000000000000000000000100000010000000000000000000000000000000000000000000000000000000000000000000000000000000000000000100000000000000000000000000000001
11111111111111111111111111111111111111111111111111111111111111111111111111111111111111111111111111111111111111111111111111111111111111111111111111111111
10000000000000000000000000000000000000000000000000000000000000000000000000000000000000000000000000000000000000000000000000000000000000000000000000000001